{
  "name": "Level 3: Celestial Ascent",
  "gridWidth": 28,
  "gridHeight": 63,
  "background": "background_blue",
  "startPosition": {
    "x": 2.08,
    "y": 58.33
  },
  "layout": [
    "0000000000000000000000000000",
    "0000000000000000000000000000",
    "0000000000000000000000000000",
    "0000000000000000000000000000",
    "0000000000000000000000000000",
    "0000000000000000000000000000",
    "0000000000000000000000000000",
    "0000000000000000000000000000",
    "0000000000000000000000000000",
    "0000000000000000000000000000",
    "0000000000000000000000000000",
    "0000000000000000000000000000",
    "0000000000000000000000000000",
    "0000000000000000000000000000",
    "0000000000000000000000000000",
    "0000004444000000000000000000",
    "0000000000000000000000000000",
    "0000000000000000000000000000",
    "0999000000000000000000000000",
    "0000003333000000000000000000",
    "0000000000000000000000000000",
    "0000000000000000000000000000",
    "0000000000000066600000000000",
    "0000000000000000000000000000",
    "0000000000000000000000000000",
    "0000000000000000000000000000",
    "0000000000000000022000000000",
    "0000000000000000022000000000",
    "0000000000000000022000000000",
    "0000000000000000000000550000",
    "0000000000000000000000000000",
    "0000000000000000000000000000",
    "0000000000000000006600000000",
    "0000000000000000000000000000",
    "0000000000000000000000000000",
    "0000000000000000000000330000",
    "0000000000000000000000000000",
    "0000000000000000000000000000",
    "0000000000000000002000000000",
    "0000000000000000002000000000",
    "0000000000000000002000000000",
    "0000000000000440000000000000",
    "0000000000000000000000000000",
    "0000000000000000000000000000",
    "0000000030000000000000000000",
    "0000000030000000000000000000",
    "0000000030000000000000000000",
    "0022200000000000000000000000",
    "0000000000000000000000000000",
    "0000000000000000000000000000",
    "0000000000000000000000000000",
    "0000006600000000000000000000",
    "0000000000000000000000000000",
    "0000000000000000000000000000",
    "0000000000333000000000000000",
    "0000000000000000000000000000",
    "0000000000000000000000000000",
    "0000005500000000000000000000",
    "0000000000000000000000000000",
    "0000000000000000000000000000",
    "0111000000000000000000000000",
    "0000000000000000000000000000",
    "0000000000000000000000000000"
  ],
  "objects": [
    {
      "type": "fruit_apple",
      "x": 11.73,
      "y": 51.81
    },
    {
      "type": "fruit_bananas",
      "x": 3.42,
      "y": 45.42
    },
    {
      "type": "fruit_cherries",
      "x": 14.02,
      "y": 39.9
    },
    {
      "type": "fruit_kiwi",
      "x": 18.6,
      "y": 36.69
    },
    {
      "type": "fruit_melon",
      "x": 19.11,
      "y": 30.77
    },
    {
      "type": "fruit_orange",
      "x": 18.4,
      "y": 24.29
    },
    {
      "type": "fruit_pineapple",
      "x": 2.5,
      "y": 16.75
    },
    {
      "type": "fruit_strawberry",
      "x": 13.13,
      "y": 18.98
    },
    {
      "type": "checkpoint",
      "x": 23,
      "y": 34.33
    },
    {
      "type": "trophy",
      "x": 8.23,
      "y": 14.67
    }
  ]
}