{
  "name": "Level 5: Leaps of Faith",
  "gridWidth": 27,
  "gridHeight": 59,
  "background": "background_pink",
  "startPosition": {
    "x": 22.92,
    "y": 54.17
  },
  "layout": [
    "000000000000000000000000000",
    "000000000000000000000000000",
    "000000000000000000000000000",
    "000000000000000000000000000",
    "000000000000000000000000000",
    "000000000000000000000000000",
    "000000000000000000000000000",
    "000000000000000000000000000",
    "000000000000000000000000000",
    "000000000000000000000000000",
    "000000000000000000000000000",
    "000000000000000000000000000",
    "000000000000000000000000000",
    "000000000000000000000000000",
    "000000000000000000000000000",
    "000000000000000000000000000",
    "000000000000000000000000000",
    "000000000000000000000000000",
    "000000000000000000000000000",
    "000000000000000000000000000",
    "000000000000000000000000000",
    "000000000000000000000000000",
    "000000000000000000000000000",
    "000000000000000000000000000",
    "000000000000000000000000000",
    "000000000000000000000000000",
    "000000000000000000000000000",
    "000000000000000000000000000",
    "000000000000000000000000000",
    "000000000000000000000000000",
    "000000000000000000000000000",
    "000000000000000000000000000",
    "000550000000000000000000000",
    "000000000000000000000000000",
    "000000000888000000000000000",
    "000000000000000000000000000",
    "000000000000000022220000000",
    "000000000000000000000000000",
    "000000000000000000000000000",
    "000000000000000000000500000",
    "000000000000000000000000000",
    "000000000000000000000000000",
    "000000000000000044400000000",
    "000000000000000000000000000",
    "000000000000000000000000000",
    "000000000066000000000000000",
    "000000000000000000000000000",
    "000000000000000000000000000",
    "000020000000000000000000000",
    "000020000000000000000000000",
    "000020000000000000000000000",
    "000020000033300000000000000",
    "000000000000000000000000000",
    "000000000000000000000000000",
    "000000000000000770000000000",
    "000000000000000000000000000",
    "000000000000000000001111000",
    "000000000000000000000000000",
    "000000000000000000000000000"
  ],
  "objects": [
    {
      "type": "fruit_apple",
      "x": 16.07,
      "y": 52.48
    },
    {
      "type": "fruit_bananas",
      "x": 4.54,
      "y": 47.07
    },
    {
      "type": "fruit_cherries",
      "x": 17.25,
      "y": 33.91
    },
    {
      "type": "fruit_kiwi",
      "x": 21.53,
      "y": 37.62
    },
    {
      "type": "fruit_melon",
      "x": 10.42,
      "y": 33.33
    },
    {
      "type": "fruit_orange",
      "x": 7.26,
      "y": 31.12
    },
    {
      "type": "fruit_pineapple",
      "x": 13.11,
      "y": 42.52
    },
    {
      "type": "fruit_strawberry",
      "x": 11.61,
      "y": 49.57
    },
    {
      "type": "checkpoint",
      "x": 17.4,
      "y": 41.33
    },
    {
      "type": "trophy",
      "x": 4.17,
      "y": 31.67
    }
  ]
}