{
  "name": "Level 6: Zigging and Zagging",
  "gridWidth": 28,
  "gridHeight": 67,
  "background": "backgroundTile",
  "startPosition": {
    "x": 3.13,
    "y": 62.5
  },
  "layout": [
    "0000000000000000000000000000",
    "0000000000000000000000000000",
    "0000000000000000000000000000",
    "0000000000000000000000000000",
    "0000000000000000000000000000",
    "0000000000000000000000000000",
    "0000000000000000000000000000",
    "0000000000000000000000000000",
    "0000000000000000000000000000",
    "0000000000000000000000000000",
    "0000000000000000000000000000",
    "0000000000000000000000000000",
    "0000000000000000000000000000",
    "0000000000000000000000000000",
    "0000000000000000000000000000",
    "0000000000000000000000000000",
    "0000000000000000000000000000",
    "0000000000000000000000000000",
    "0000000000000000000000000000",
    "0000000000000000000000000000",
    "0000000000000000000000000000",
    "0000000000000000000000000000",
    "0000000000000000000000000000",
    "0000000000000000000000000000",
    "0000000000000000000000000000",
    "0000000000000000000000000000",
    "0000000000000000000000000000",
    "0000000000000000000000000000",
    "0000000000000000000000000000",
    "0000000000000000000000000000",
    "0000000000000000000000000000",
    "0000000000000000000000000000",
    "0000000000000000000000000000",
    "0000000000000000000000000000",
    "0000000000000000000000000000",
    "0000000000000000000000000000",
    "0000000000000000000000000000",
    "0000000000000000000000000000",
    "0000000000000000000000000000",
    "0000000000000000000000000000",
    "0000000000000000000000000000",
    "0000000000000000000000000000",
    "0000000000000000000033330000",
    "0000000000000000000000000000",
    "0000000000002200000000000000",
    "0000000000002200000000000000",
    "0044400000002200000000000000",
    "0000000000000000000000000000",
    "0000000000000000000000000000",
    "0000000000000000000000000000",
    "0000000000600000000000000000",
    "0000000000600000000000000000",
    "0000000000600000000000000000",
    "0033300000600000000000000000",
    "0000000000000000000000000000",
    "0000000000000000000000000000",
    "0000000055550000000000000000",
    "0000000000000000000000000000",
    "0000000000000000000000000000",
    "0022200000000000000000000000",
    "0000000000000000000000000000",
    "0000000000000000000000000000",
    "0000000033330000000000000000",
    "0000000000000000000000000000",
    "0044400000000000000000000000",
    "0000000000000000000000000000",
    "0000000000000000000000000000"
  ],
  "objects": [
    {
      "type": "fruit_apple",
      "x": 9.38,
      "y": 61.04
    },
    {
      "type": "fruit_bananas",
      "x": 3.13,
      "y": 58.33
    },
    {
      "type": "fruit_cherries",
      "x": 11.82,
      "y": 54.86
    },
    {
      "type": "fruit_kiwi",
      "x": 3.13,
      "y": 52.08
    },
    {
      "type": "fruit_melon",
      "x": 10.46,
      "y": 48.75
    },
    {
      "type": "fruit_orange",
      "x": 12.96,
      "y": 43
    },
    {
      "type": "fruit_pineapple",
      "x": 3.48,
      "y": 44.64
    },
    {
      "type": "fruit_strawberry",
      "x": 17.99,
      "y": 40.78
    },
    {
      "type": "trophy",
      "x": 23.08,
      "y": 41.67
    }
  ]
}