{
  "name": "Level 7: Precision Drops",
  "gridWidth": 27,
  "gridHeight": 42,
  "background": "backgroundTile",
  "startPosition": {
    "x": 2.08,
    "y": 6.25
  },
  "layout": [
    "000000000000000000000000000",
    "000000000000000000000000000",
    "000000000000000000000000000",
    "000000000000000000000000000",
    "000000000000000000000000000",
    "000000000000000000000000000",
    "000000000000000000000000000",
    "000000000000000000000000000",
    "022200000000000000000000000",
    "000000000000000000000000000",
    "000000000000000000000000000",
    "000000110000000000000000000",
    "000000000000000000000000000",
    "000000000000000000000000000",
    "000000000033300000000000000",
    "000000000000000000000000000",
    "000000000000000000000000000",
    "000000330000000000000000000",
    "000000000000000000000000000",
    "000000000000000000000000000",
    "000000000044400000000000000",
    "000000000000000000000000000",
    "000000000000000000000000000",
    "000000000000000660000000000",
    "000000000000000000000000000",
    "000000000000000000000000000",
    "000000000000000000000000000",
    "000000000000000000055500000",
    "000000000000000000000000000",
    "000000000000000000000000000",
    "000000000000000220000000000",
    "000000000000000000000000000",
    "000000000000000000000000000",
    "000000000011110000000000000",
    "000000000000000000000000000",
    "000000000000000000000000000",
    "000000000000000033300000000",
    "000000000000000000000000000",
    "000000000000000000000000000",
    "000000000000000000000000000",
    "000000000000000000000000000",
    "000000000000000000000000000"
  ],
  "objects": [
    {
      "type": "fruit_apple",
      "x": 11.58,
      "y": 12.73
    },
    {
      "type": "fruit_bananas",
      "x": 6.96,
      "y": 16.09
    },
    {
      "type": "fruit_cherries",
      "x": 11.5,
      "y": 18.85
    },
    {
      "type": "fruit_kiwi",
      "x": 20.83,
      "y": 26.04
    },
    {
      "type": "fruit_melon",
      "x": 11.46,
      "y": 32.29
    },
    {
      "type": "fruit_orange",
      "x": 19,
      "y": 32.86
    },
    {
      "type": "fruit_pineapple",
      "x": 9.01,
      "y": 23.91
    },
    {
      "type": "fruit_strawberry",
      "x": 16.05,
      "y": 28.82
    },
    {
      "type": "trophy",
      "x": 17.71,
      "y": 35.67
    }
  ]
}