{
  "name": "Level 9: The Summit",
  "gridWidth": 27,
  "gridHeight": 42,
  "background": "backgroundTile",
  "startPosition": {
    "x": 12.5,
    "y": 37.5
  },
  "layout": [
    "000000000000000000000000000",
    "000000000000000000000000000",
    "000000000000000000000000000",
    "000000000000000000000000000",
    "000000000000000000000000000",
    "000000000000000000000000000",
    "000000000000000000000000000",
    "000000000000000000000000000",
    "000000000000000000000000000",
    "000000000000000000000000000",
    "000000000000000000000000000",
    "000000000000000000000000000",
    "000000000000000000000222000",
    "000000000000000000000000000",
    "000000000000000000000000000",
    "000000000000000033330000000",
    "000000000000000000000000000",
    "000000000000000000000000000",
    "000000000001100000000000000",
    "000000000000000000000000000",
    "000000000000000000000000000",
    "000000222000000000000000000",
    "000000000000000000000000000",
    "000000000000000000000000000",
    "055550000000000000000000000",
    "000000000000000000000000000",
    "000000000000000000000000000",
    "000000660000000000000000000",
    "000000000000000000000000000",
    "000000000004440000000000000",
    "000000000000000000000000000",
    "000000000000000000000000000",
    "000000000000000033330000000",
    "000000000000000000000000000",
    "000000000001100000000000000",
    "000000000000000000000000000",
    "000000000000000000000000000",
    "000000333000000000000000000",
    "000000000000000000000000000",
    "000000000002222000000000000",
    "000000000000000000000000000",
    "000000000000000000000000000"
  ],
  "objects": [
    {
      "type": "fruit_apple",
      "x": 8.62,
      "y": 33.94
    },
    {
      "type": "fruit_bananas",
      "x": 17.71,
      "y": 31.04
    },
    {
      "type": "fruit_cherries",
      "x": 7.29,
      "y": 26.04
    },
    {
      "type": "fruit_kiwi",
      "x": 1.83,
      "y": 22.48
    },
    {
      "type": "fruit_melon",
      "x": 13.69,
      "y": 15.88
    },
    {
      "type": "fruit_orange",
      "x": 18.98,
      "y": 12.3
    },
    {
      "type": "fruit_pineapple",
      "x": 12.69,
      "y": 27.46
    },
    {
      "type": "fruit_strawberry",
      "x": 8.88,
      "y": 19.12
    },
    {
      "type": "trophy",
      "x": 23.33,
      "y": 11.67
    }
  ]
}