{
  "name": "02",
  "gridWidth": 27,
  "gridHeight": 53,
  "background": "background_blue",
  "startPosition": {
    "x": 13.33,
    "y": 47.92
  },
  "layout": [
    "000000000000000000000000000",
    "000000000000000000000000000",
    "000000000000000000000000000",
    "000000000000000000000000000",
    "000000000000000000000000000",
    "000000000000000000000000000",
    "000000000000000000000000000",
    "000000000000000000000000000",
    "000000000000000000000000000",
    "000000000000000000000000000",
    "000000000000000000022220000",
    "000000000000000000000000000",
    "000000000000000000000000000",
    "000000000000011100000000000",
    "000000000000000000000000000",
    "000000000000000000000000000",
    "000000000400000000000000000",
    "000000000000000000000000000",
    "000000000000000000000000000",
    "000033330000000000000000000",
    "000000000000000000000000000",
    "000000000000000000000000000",
    "000000000330000000000000000",
    "000000000000000000000000000",
    "000000000000000000000000000",
    "000000000000000000000000000",
    "000000000000002220000000000",
    "000000000000000000000000000",
    "000000000000000000000000000",
    "000000000000000000660000000",
    "000000000000000000000000000",
    "000000000000000000000000000",
    "000000000000055500000000000",
    "000000000000000000000000000",
    "000000000000000000000000000",
    "000000002000000000000000000",
    "000000000000000000000000000",
    "000000000000000000000000000",
    "000660000000000000000000000",
    "000000000000000000000000000",
    "000000000000000000000000000",
    "000000033330000000000000000",
    "000000000000000000000000000",
    "000000000000000000000000000",
    "000000000000444000000000000",
    "000000000000000000000000000",
    "000000000000000000000000000",
    "000000000000000011000000000",
    "000000000000000000000000000",
    "000000000000000000000000000",
    "000000000001111000000000000",
    "000000000000000000000000000",
    "000000000000000000000000000"
  ],
  "objects": [
    {
      "type": "fruit_apple",
      "x": 17.44,
      "y": 45.71
    },
    {
      "type": "fruit_bananas",
      "x": 8.46,
      "y": 39.8
    },
    {
      "type": "fruit_cherries",
      "x": 3.92,
      "y": 36.73
    },
    {
      "type": "fruit_kiwi",
      "x": 14.58,
      "y": 31.25
    },
    {
      "type": "fruit_melon",
      "x": 15.63,
      "y": 25
    },
    {
      "type": "fruit_orange",
      "x": 5.21,
      "y": 17.52
    },
    {
      "type": "fruit_pineapple",
      "x": 14.58,
      "y": 11.46
    },
    {
      "type": "fruit_strawberry",
      "x": 10.67,
      "y": 13.04
    },
    {
      "type": "checkpoint",
      "x": 19.25,
      "y": 28.33
    },
    {
      "type": "trophy",
      "x": 21.79,
      "y": 9.67
    }
  ]
}