{
  "name": "Level 4: Dash Gauntlet",
  "gridWidth": 30,
  "gridHeight": 42,
  "background": "background_green",
  "startPosition": {
    "x": 2.3,
    "y": 37.5
  },
  "layout": [
    "000000000000000000000000000000",
    "000000000000000000000000000000",
    "000000000000000000000000000000",
    "000000000000000000000000000000",
    "000000000000000000000000000000",
    "000000000000000000000000000000",
    "000000000000000000000000000000",
    "000000000000000000000000000000",
    "000000000000000000000000000000",
    "000000000000000000000000000000",
    "000000000000000000000000000000",
    "000000000000000000000000000000",
    "000000000000000000000000000000",
    "000000000000000000000000000000",
    "000000000000000000000000000000",
    "000000000000000000000000000000",
    "000000000000000000000000000000",
    "000000000000000000000000000000",
    "000000000000000000000000000000",
    "000000000000000000000000000000",
    "000000000000000000000000000000",
    "000000000000000000000000000000",
    "000000000000000002200000000000",
    "000000000000000000000000000000",
    "000000000000000000000000000000",
    "000000000066600000000000000000",
    "000000000000000000000000000000",
    "000000000000000000000000000000",
    "000055550000000000000000000000",
    "000000000000000000000000000000",
    "000000000099000000000000000000",
    "000000000000000000000000000000",
    "000000000000000044400000000000",
    "000000000000000000000000000000",
    "000000000000000000000000000000",
    "000000000000000000003333000000",
    "000000000000000000000000000000",
    "000000000000007700000000000000",
    "000000008880000000000000000000",
    "011110000000000000000000000000",
    "000000000000000000000000000000",
    "000000000000000000000000000000"
  ],
  "objects": [
    {
      "type": "fruit_apple",
      "x": 9.38,
      "y": 37.5
    },
    {
      "type": "fruit_bananas",
      "x": 15.63,
      "y": 36.04
    },
    {
      "type": "fruit_cherries",
      "x": 22.53,
      "y": 33.94
    },
    {
      "type": "fruit_kiwi",
      "x": 17.71,
      "y": 31.25
    },
    {
      "type": "fruit_melon",
      "x": 5.21,
      "y": 27.08
    },
    {
      "type": "fruit_orange",
      "x": 11.46,
      "y": 23.96
    },
    {
      "type": "fruit_pineapple",
      "x": 4.91,
      "y": 36.36
    },
    {
      "type": "fruit_strawberry",
      "x": 14.21,
      "y": 21.69
    },
    {
      "type": "checkpoint",
      "x": 10.83,
      "y": 29.33
    },
    {
      "type": "trophy",
      "x": 18.48,
      "y": 21.67
    }
  ]
}