{
  "name": "Level 8: Final Ascent",
  "gridWidth": 30,
  "gridHeight": 73,
  "background": "background_blue",
  "startPosition": {
    "x": 2.04,
    "y": 68.38
  },
  "layout": [
    "000000000000000000000000000000",
    "000000000000000000000000000000",
    "000000000000000000000000000000",
    "000000000000000000000000000000",
    "000000000000000000000000000000",
    "000000000000000000000000000000",
    "000000000000000000000000000000",
    "000000000000000000000000000000",
    "000000000000000000000000000000",
    "000000000000000000000000000000",
    "000000000000000000000000000000",
    "000000000000000000000000000000",
    "000000000000000000000000000000",
    "000000000000000000000000000000",
    "000000000000000000000000000000",
    "000000000000000000000000000000",
    "000000000000000000000000000000",
    "000000000000000000000000000000",
    "000000000000000000000000000000",
    "000000000000000000000000000000",
    "000000000000000000000000000000",
    "000000000000000000000000000000",
    "000000000000000000000000000000",
    "000000000000000000000000000000",
    "000000000000000000000000000000",
    "000000000000000000000000000000",
    "000000000000000000000000000000",
    "000000000000000000000000000000",
    "000000000000000000000000000000",
    "000000000000000000000000000000",
    "000000000000000000000000000000",
    "000000000000000000000000000000",
    "000000000000000000000000000000",
    "000000000000000000000000000000",
    "000000000000000000000000000000",
    "000000000000000000000000000000",
    "000000000000000000000000444400",
    "000000000000000000000000000000",
    "000000000000000000000000000000",
    "000000000000011100000000000000",
    "000000000000000000000000000000",
    "000000000000000000000100000000",
    "000000033330000000000000000000",
    "000000000000000000000000000000",
    "000000000000000000000000000000",
    "006600000000000000000000000000",
    "000000000000000000000000000000",
    "000000000000000000000000000000",
    "000000022200000000000000000000",
    "000000000200000000000000000000",
    "000000000000000000000000000000",
    "000000000000000000000000000000",
    "000000000000555500000000000000",
    "000000000000000000000000000000",
    "000000000000000000000000000000",
    "000000000000000006600000000000",
    "000000000000000000000000000000",
    "000000000000000000000000000000",
    "000000000000000000000044400000",
    "000000000000000000000000000000",
    "000000000000000000000000000000",
    "000000000000000003333000000000",
    "000000000000000000000000000000",
    "000000000000000000000000000000",
    "000000000000330000000000000000",
    "000000000000000000000000000000",
    "000000000000000000000000000000",
    "000000022200000000000000000000",
    "000000020000000000000000000000",
    "000000000000000000000000000000",
    "011110000000000000000000000000",
    "000000000000000000000000000000",
    "000000000000000000000000000000"
  ],
  "objects": [
    {
      "type": "fruit_apple",
      "x": 8.52,
      "y": 65.15
    },
    {
      "type": "fruit_bananas",
      "x": 18.77,
      "y": 59.65
    },
    {
      "type": "fruit_cherries",
      "x": 12.35,
      "y": 49.82
    },
    {
      "type": "fruit_kiwi",
      "x": 6.16,
      "y": 46.38
    },
    {
      "type": "fruit_melon",
      "x": 4.59,
      "y": 43.02
    },
    {
      "type": "fruit_orange",
      "x": 18,
      "y": 37.62
    },
    {
      "type": "fruit_pineapple",
      "x": 23.44,
      "y": 56.95
    },
    {
      "type": "fruit_strawberry",
      "x": 9.02,
      "y": 40.92
    },
    {
      "type": "trophy",
      "x": 25.27,
      "y": 35.67
    },
    {
      "type": "checkpoint",
      "x": 18.08,
      "y": 54.33
    },
    {
      "type": "trampoline",
      "x": 10.19,
      "y": 41.71
    },
    {
      "type": "trampoline",
      "x": 21.5,
      "y": 40.71
    }
  ]
}